111111111111111111111111111
1000E000000P1000000000C1011
100000011000000000000010001
100000000000001000000000001
1000000C0100010000000000001
100000000100000100001000001
100000010000010C00100000001
111111111111111111111111111