111111111111111111111111111
1000E100C100000000000000001
100010001100000000000000001
100000000000001000000000001
1000000001000C0000000000001
10000000010000010000P000001
100000010000010000C00000001
111111111111111111111111111