111111111111111111111111111
1000E00CCCC0P10000000000001
100000011000000000000000001
100000000000001000000000001
100000000100010000000000001
100000000100000100001000001
100000010000010000100000001
111111111111111111111111111
