11111111111
1E100C00011
1110000P101
1100C000111
11111111111
