111111111111111111111111111
10010000C1E0000000000000001
100000001100000000000000001
100000000000001000000000001
1000000001000C0000000000001
10000000010000010000P000001
100000010000010000C00000001
111111111111111111111111111
