1111111111111111111111111111111
10P0000001000000000000001000011
10000000010000000000000000E0011
1000000000000000100000000111111
1000000001000000000000000000001
1000000001000000000000000000001
10000001000000010000C0000000001
1111111111111111111111111111111