1111111111111111111111111111111
1001000001E00000000000100001111
1000000001000000000000000010011
1000000000000000100000000111111
1000000001000C00000000000000011
1000000001000000010000P00000001
10000001000000010000C0000000011
1111111111111111111111111111111
