111111111111111111111111111
1001000001E0000000100001111
100000000100000000000010011
100000000000001000000111111
1000000001000C0000000000011
10000000010000010000P000001
100000010000010000C00000011
111111111111111111111111111
