111111111
1CEP11111
100000001
111111111