01111111111111
1000E100C10001
10011101110001
1000000C000111
10C00001000C11
1000000P000001
10000000C00001
11111111111111
