11111
10101
1P1C1
10001
11E11
11111