11111111111
1E100C00011
1110000P11
11111111111
11111111111